####################
#@      #   #   #? #
# # ### # # ### ## #
# #   # # #   #    #
# ##### # # #### # #
#  #    # #      # #
## # #### # #### # #
## # #    #    # # #
## #   ####### # # #
## # # #     # # # #
#  # #   # #   #   #
# ######## ####### #
#    #     #   #!  #
#### # ##### # #####
#    #    #  # # # #
# # ##### # ## # # #
# #     # # #      #
# ##### # # ###### #
#    /# #        # #
####################